new
32 20
85 ./textures/
1 apple32.png
0 brick.png
0 brick.png
1 apple32.png
0 brick.png
0 brick.png
1 tender2.png
0 brick.png
0 brick.png
1 tender2.png
1 tender2.png
0 brick.png
0 brick.png
1 tender2.png
1 tender2.png
0 brick.png
0 brick.png
1 tender2.png
0 brick.png
0 brick.png
1 tender2.png
0 brick.png
1 apple32.png
1 apple32.png
0 brick.png
1 tender2.png
0 brick.png
0 brick.png
0 brick.png
0 brick.png
1 tender2.png
0 brick.png
0 brick.png
0 brick.png
0 brick.png
1 tender2.png
0 brick.png
0 brick.png
0 brick.png
0 brick.png
1 tender2.png
0 brick.png
0 brick.png
0 brick.png
0 brick.png
1 tender2.png
0 brick.png
0 brick.png
0 brick.png
0 brick.png
1 tender2.png
0 brick.png
1 apple32.png
1 apple32.png
1 apple32.png
1 apple32.png
1 apple32.png
1 apple32.png
1 apple32.png
0 brick.png
0 brick.png
1 apple32.png
1 apple32.png
1 apple32.png
1 apple32.png
1 tender2.png
0 brick.png
0 brick.png
0 brick.png
0 brick.png
0 brick.png
0 brick.png
0 brick.png
0 brick.png
0 brick.png
0 brick.png
0 brick.png
0 brick.png
0 brick.png
0 brick.png
1 tender.png
1 tender.png
1 tender.png
3 magiceye.png exit.png
1 tender.png
0 0 0 0 0 0 0 0 0 0 0 0 0 0 0 0 0 0 0 0 
0 0 0 0 0 0 0 0 0 0 0 0 0 0 0 0 0 0 0 0 
0 0 0 0 0 0 0 0 0 0 0 0 0 0 0 0 0 0 0 0 
0 0 0 0 0 0 1 0 0 0 0 0 0 0 0 0 0 0 0 0 
0 0 0 0 0 0 0 0 0 0 0 0 0 0 0 0 0 0 2 0 
0 0 0 0 0 0 0 0 0 0 0 0 0 0 0 0 0 0 0 0 
0 0 0 0 0 0 0 0 0 0 3 0 0 0 0 0 0 0 0 0 
0 0 0 0 0 0 0 4 0 0 0 0 0 0 0 0 0 0 0 0 
0 0 5 0 0 0 0 0 0 0 0 0 0 0 0 0 0 0 0 6 
0 0 0 0 0 0 0 0 7 0 0 0 0 0 8 0 0 0 0 0 
0 0 0 0 0 0 0 0 0 0 0 9 0 0 0 0 0 0 0 10 
11 0 0 0 0 0 12 0 0 0 0 0 0 0 0 0 0 0 0 0 
0 0 0 13 0 0 0 0 0 0 14 0 15 0 0 0 0 0 16 0 
0 0 0 0 0 0 0 0 0 0 0 0 0 0 0 17 0 0 0 0 
0 0 0 0 18 0 0 0 0 0 19 0 -1 0 0 0 0 0 0 0 
0 0 0 0 0 0 0 20 0 0 0 0 0 0 0 0 21 0 0 0 
0 0 22 0 0 0 0 0 0 23 0 0 0 0 0 24 0 0 0 25 
0 0 0 0 0 0 0 0 26 0 0 0 0 0 27 0 0 0 0 0 
0 28 0 0 0 0 0 29 0 0 0 30 0 0 0 0 0 0 0 0 
31 0 0 0 0 0 32 0 0 0 0 0 0 33 0 0 0 0 0 34 
0 0 0 35 0 0 0 0 0 0 0 0 36 0 0 0 0 0 37 0 
0 0 0 0 0 0 38 0 0 0 39 0 0 0 0 40 0 0 0 0 
0 0 0 0 41 0 0 0 0 0 42 0 0 0 0 0 0 0 43 0 
0 0 44 0 0 0 0 45 0 0 0 0 0 0 0 0 46 0 0 0 
0 0 47 0 0 0 0 0 0 0 0 48 0 49 0 0 0 0 0 50 
0 0 0 0 0 0 0 0 51 0 0 0 0 0 52 53 54 55 56 57 
58 59 0 0 60 0 0 0 0 0 0 61 62 63 64 65 0 0 0 0 
66 0 0 0 0 0 67 68 69 70 71 72 73 74 0 0 75 0 0 0 
0 0 0 76 77 78 79 80 0 0 81 82 83 84 85 0 0 0 0 0 
0 0 0 0 0 0 0 0 0 0 0 0 0 0 0 0 0 0 0 0 
0 0 0 0 0 0 0 0 0 0 0 0 0 0 0 0 0 0 0 0 
0 0 0 0 0 0 0 0 0 0 0 0 0 0 0 0 0 0 0 0 
